20 20
....................
....................
....................
....................
.....########.......
.....#.MMM..#.......
.....#.MMM..#.......
...##########.......
....................
....................