20 20
....................
....................
..#.................
.#..................
.#..######M#........
.#.......MOM........
M#........M#........
M###########HH......
M#..........HMH.....
##..........HHH.....
....................
....................
....................
.....EEE............
....................
....................
....................
....................