20 20
.M..................
....................
....................
....................
.....#..............
.....#..............
.....#..............
...#####............
....................
.........M..........