20 20
....................
.......MM...........
..#.................
.#..................
.#..######M#.#......
.#.......MOM.#......
M#........M#........
.###########HH......
M#..........HM#.....
##..........#.#.....
....................
....................
....................
.....EEE...MMM......
....................
.......MMMM.........
..............HH....
....................